aalscholver	'al-sxOl-v@r
aap	'ap
aardmannetje	'ard-mA-n@-tj@
aasgier	'as-xir
agapornis	a-Ga-'pOr-nIs
ai	'Aj
alk	'Alk
alpaca	'Al-pa-ka
arendbuizerd	'a-r@nd-bY+-z@rt
atalanta	a-ta-'lAn-ta
atlasvlinder	'At-lAs-flIn-d@r
axolotl	'Ak-so-lOtl
bergeend	'bErG-ent
bergleeuw	'bEr-Glew
bever	'be-v@r
beverrat	'be-v@-rAt
bijeneter	'bE+-j@-e-t@r
bongo	'bON-go
boomklever	'bom-kle-v@r
boommarter	'bo-mAr-t@r
bosduivel	'bOz-dY+-v@l
bosfazant	'bOs-fa-zAnt
bosuil	'bOs-Y+l
brahma	'brAG-ma
brandgans	'brAnt-xAns
brilslang	'brIl-slAN
brulaap	'brYl-ap
buizerd	'bY+-z@rt
bunzing	'bYn-zIN
cheeta	'tSi-ta
chinchilla	tSIn-'tSI-la
cobra	'ko-bra
dagpauwoog	'dAx-pA+w-ox
damhert	'dAm-hErt
das	'dAs
dromedaris	dro-m@-'da-r@s
edelhert	'e-d@l-hErt
eekhoorn	'ek-horn
egel	'e-G@l
eiber	'E+-b@r
eidereend	'E+-d@r-ent
eikelmuis	'E+-k@l-mY+s
ekster	'Ek-st@r
eland	'e-lAnt
emoe	'e-mu
ever	'e-v@r
everzwijn	'e-v@r-zwE+n
flamingo	fla-'mIN-go
fluiteend	'flY+t-ent
fuut	'fyt
garibaldi	ga-ri-'bAl-di
gems	'xEms
gifkikker	'xIf-kI-k@r
giraffe	xi-'rA-f@
goochelaar	'xo-x@-lar
gorilla	xo-'rI-la
goudfazant	'xA+t-fa-zAnt
goudvis	'xA+t-fIs
grasparkiet	'xrAs-pAr-kit
groentje	'xrun-tj@
haas	'has
hamerkop	'ha-m@r-kOp
hamster	'hAm-st@r
hazelmuis	'ha-z@l-mY+s
hazelworm	'ha-z@l-wOrm
heremietkreeft	he-re-'mit-kreft
hermelijn	hEr-m@-'lE+n
hond	'hOnt
honingbeer	'ho-nIN-ber
hooibeestje	'hoj-best-j@
hoornaar	'hor-nar
houtduif	'hA+-dY+f
huishond	'hY+s-hOnt
huiskat	'hY+s-kAt
huismuis	'hY+s-mY+s
hyenahond	hi-'je-na-hOnt
impala	Im-'pa-la
jachtluipaard	'jAxt-lY+-part
jaguar	'ja-gu-wAr
jak	'jAk
jan-van-gent	jAn-vAN-'GEnt
kabeljauw	ka-b@l-'jA+w
kalkoen	kAl-'kun
kameel	ka-'mel
karetschildpad	ka-'rEt-sxIlt-pAt
kariboe	ka-ri-'bu
kat	'kAt
kerkuil	'kErk-Y+l
kievit	'ki-vIt
klapperrat	'klA-p@-rAt
kluut	'klyt
koereiger	'ku-rE+-G@r
koffierat	'kO-fi-rAt
koi	ko-'wi
kolibrie	'ko-li-bri
konijn	ko-'nE+n
koninginnepage	ko-nI-'NI-n@-pa-Z@
koningsgier	'ko-nINs-xir
koningstijger	'ko-nINs-tE+-G@r
koolmees	'kol-mes
krooneend	'kron-ent
kruisspin	'krY+-spIn
kwak	'kwAk
lachduif	'lAG-dY+f
lachvogel	'lAx-fo-G@l
lama	'la-ma
lampongaap	'lAm-pON-ap
landkaartje	'lAnt-kart-j@
lanspuntslang	'lAns-pYnt-slAN
leeuw	'lew
leguaan	le-Gy-'wan
lieveling	'li-v@-lIN
luipaard	'lY+-part
luipaardhaai	'lY+-part-haj
lynx	'lINks
mandril	mAn-'drIl
manenrob	'ma-n@-rOp
manenschaap	'ma-n@-sxap
mantelbaviaan	'mAn-t@l-ba-vi-jan
mara	'ma-ra
maraboe	'ma-ra-bu
merel	'me-r@l
mestkever	'mEst-ke-v@r
moeflon	'muf-lOn
mol	'mOl
muggen	'mY-G@
muskusos	'mYs-kYs-Os
muskusrat	'mYs-kYs-rAt
netpython	'nEt-pi-tOn
neushoorn	'n2s-horn
nijlgans	'nE+l-GAns
nijlpaard	'nE+l-part
nonnetje	'nO-n@-tj@
notekraker	'no-t@-kra-k@r
oehoe	'u-hu
oeros	'ur-Os
oester	'us-t@r
okapi	o-'ka-pi
otter	'O-t@r
papegaaiduiker	'pa-p@-Gaj-dY+-k@r
patrijs	pA-'trE+s
pauw	'pA+w
pelikaan	pe-li-'kan
pipa	'pi-pa
piranha	pi-'rA-Ja
poema	'pu-ma
poolvos	'pol-vOs
prairiehond	'prE:-ri-hOnt
purperkoet	'pYr-p@r-kut
raaf	'raf
ransuil	'rAns-Y+l
ree	're
regenworm	're-G@n-wOrm
regenwulp	're-G@n-wYlp
relmuis	'rEl-mY+s
rendier	'rEn-dir
reuzenpad	'r2-z@m-pAt
rijstvogel	'rE+st-fo-G@l
rioolrat	ri-'jol-rAt
roodhalsgans	'rot-hAls-xAns
rotspython	'rOts-pit-hOn
sabelantilope	'sa-b@l-An-ti-lo-p@
schaap	'sxap
scharrelaar	'sxA-r@-lar
schol	'sxOl
scholekster	'sxOl-Ek-st@r
schollevaar	'sxO-l@-var
scholver	'sxOl-v@r
scholverd	'sxOl-v@rt
secretarisvogel	se-kr@-'ta-r@s-fo-G@l
sidderaal	'sI-d@r-al
slijmvis	'slE+m-vIs
slobeend	'slob-ent
smient	'smint
sprinkhaan	'sprINk-han
steenhommel	'sten-hO-m@l
steenmarter	'sten-mAr-t@r
steenuil	'sten-Y+l
stekelrog	'ste-k@l-rOx
stekelvarken	'ste-k@l-vAr-k@
stork	'stOrk
struisvogel	'strY+s-fo-G@l
torenvalk	'to-r@n-vAlk
tureluur	'ty-r@-lyr
veelvraat	'vel-vrat
velduil	'vEld-Y+l
vogelbekdier	'vo-G@l-bEg-dir
vogels	'vo-G@ls
vos	'vOs
wasbeer	'wAz-ber
waterrat	'wa-t@-rAt
waterspitsmuis	'wa-t@r-spIts-mY+s
wespendief	'wEs-p@-dif
wezel	'we-z@l
woelrat	'wul-rAt
woestijnvos	'wus-tE+n-vOs
wolaap	'wOl-ap
wolf	'wOlf
wrattenzwijn	'vrA-t@z-wE+n
wulp	'wYlp
wyandotte	wi-jAn-'dO-t@
yokohama	jo-ko-'ha-ma
zanglijster	'zAN-lE+s-t@r
zeearend	'ze-a-r@nt
zeekoet	'ze-kut
zeepokken	'ze-pO-k@
zeeschildpad	'ze-sxIlt-pAt
zeester	'ze-stEr
zeewaaier	'ze-wa-j@r
